 NO 56 hello
 SO 51.xpm
 WE 15.xpm
 EA 11.xpm                  
 S sprite10.xpm
 F 0,123,150
 C 250,2,100
R  1000 1000

   111111111111                                     
  100000000000011                                           
  1000000000000011111111                               
  1111100000000000000001             
      100000000001111111                            
      100000000001                                   
      100000000001     11111                   
      11111111000111111100001  111    111    1   1   1  1  
      111 11111000000000000001  1  1   1  1   1   1   1  1  
              100000000000011 1111    1111   1   1   1111  1
             1000000000000001  1  1   1  1   1   1   1  1  
     11111111100000000000001  11111111  1111111111111
    100000000000000N000000001              
    100000000000000000000001                                
    1000000111111111111110011        
    1002000111110001    11111                      
    1000000011111111    100001                       
    10000000000000011111111101                   
     1111111111111000000000001        
                  11111100111                
                       1001                        
               111     1001                         
              1000111111001                         
              1000000001111  1            
              100011111     101
               111           1
            
